2222222222222222260000
111111111111111113000000000000000000000000000000
1111111111111111130000000000000000000000000000000
1111111111111111130000000000000000000000000000000
1111111111111111130000000000000000000000000000000
11111111111111111d2600000000000000000000000000000
111111111111111111130000000000000000000000000000
111111111111f5555g1300000000000000000000000000000
11111111111130000c5b00000000000000000000000000000000000000000000000
11111111111130000000000000000000000000000000000000000000000000000
1111111111113000000t000s00u00y00v00t00v0x000s000000tzu0y00000!000
111111111111d222222222222222222222222222222222600072222222222222222222222
11111111111111111111111111111111111111111f5555q00041111111111111111111111
1111111111111111111111111111111111111111130000900041111111111111111111111
1111111111111111111111111111111111111111130000000041111111111111111111111
1111111111111111111111111111111111111111130000000041111111111111111111111
11111111111111111111111111111111111111111d22222222e1111111111111111111111
1111111111111111111111111111111111111111111111111111111111111111111111111
1111111111111111111111111111111111111111111111111111111111111111111111111
1111111111111111111111111111111111111111111111111111111111111111111111111
1111111111111111111111111111111111111111111111111111111111111111111111111
1111111111111111111111111111111111111111111111111111111111111111111111111




