200000000000000000000000000000000022222211111
200000000000000000000000000000000000000021111
200000000000000000000000000000000000000021111
200000000222222000000000000000000000000021111
20000000000000000000000000000000002222221111
200020000000000000000000000000000021111111111
200000020000000000000000000222000021111111111
222000000020000000000222200000000000000000000
112000000000020000000000000000000000000000000
112000000000000002200000000000000000000000000
111222222222222221122222222222222222222222222
111111111111111111111111111111111111111111111
111111111111111111111111111111111001111111111
111111111111111111111111111111000001111111111
111111111111111111111111111000000001111111111
111111111111111111111110000000000001111111111
222222222222222222222222222222222222222222222
222222222222222222222222222222222222222222222
222222222222222222222222222222222222222222222
222222222222222222222222222222222222222222222
222222222222222222222222222222222222222222222
222222222222222222222222222222222222222222222
222222222222222222222222222222222222222222222
222222222222222222222222222222222222222222222
222222222222222222222222222222222222222222222
222222222222222222222222222222222222222222222
222222222222222222222222222222222222222222222
222222222222222222222222222222222222222222222
222222222222222222222222222222222222222222222
222222222222222222222222222222222222222222222
222222222222222222222222222222222222222222222
222222222222222222222222222222222222222222222
222222222222222222222222222222222222222222222
222222222222222222222222222222222222222222222
222222222222222222222222222222222222222222222
222222222222222222222222222222222222222222222
222222222222222222222222222222222222222222222
222222222222222222222222222222222222222222222
222222222222222222222222222222222222222222222
222222222222222222222222222222222222222222222
222222222222222222222222222222222222222222222
222222222222222222222222222222222222222222222
222222222222222222222222222222222222222222222
222222222222222222222222222222222222222222222
222222222222222222222222222222222222222222222
222222222222222222222222222222222222222222222
222222222222222222222222222222222222222222222
222222222222222222222222222222222222222222222
222222222222222222222222222222222222222222222
222222222222222222222222222222222222222222222
222222222222222222222222222222222222222222222
222222222222222222222222222222222222222222222
222222222222222222222222222222222222222222222
222222222222222222222222222222222222222222222
222222222222222222222222222222222222222222222
222222222222222222222222222222222222222222222
222222222222222222222222222222222222222222222
222222222222222222222222222222222222222222222
222222222222222222222222222222222222222222222
222222222222222222222222222222222222222222222
222222222222222222222222222222222222222222222
222222222222222222222222222222222222222222222
222222222222222222222222222222222222222222222
222222222222222222222222222222222222222222222
222222222222222222222222222222222222222222222
222222222222222222222222222222222222222222222
222222222222222222222222222222222222222222222
222222222222222222222222222222222222222222222
222222222222222222222222222222222222222222222
222222222222222222222222222222222222222222222
