2000000000000000000000000000000000
2000000000000000000000000000000000000000
2000000000000000000000000000000000000000
2000000000000000000000000000000000000000
2000000000000000000000000000000000
2000000000000000000000000000000000
20000000000000000000000000000000000
222000000000000000000000000000000000000000002
112000000000000000000000000000000000000000002
112000000000000000000000000000000000000000002
111222222222222222222222222222222222222222222
111111111111111111111111111111111111111111111
111111111111111111111111111111111001111111111
111111111111111111111111111111000001111111111
111111111111111111111111111000000001111111111
111111111111111111111110000000000001111111111




