2222222222222222260000
111111111111111113000000000000000000000000000000
1111111111111111130000000000000000000000000000000
1111111111111111130000000000000000000000000000000
1111111111111111130000000000000000000000000000000
11111111111111111d2600000000000000000000000000000
111111111111111111130000000000000000000000000000
111111111111f555555b00000000000000000000000000000
1111111111113000000000000000000000000000000000000000000000000000000
11111111111130000000000000000000000000000000000000000000000000000
1111111111113000000t000s00u00y00v00t00v0x000s000000tzu0y00000!000
111111111111d222222222222222222222222222222222600072222222222222222222222
1111111111111111111111111111111111111f55555555q00041111111111111111111111
1111111111111111111111111111111111111300000000900041111111111111111111111
1111111111111111111111111111111111111300000000000041111111111111111111111
1111111111111111111111111111111111111300000000000041111111111111111111111
1111111111111111111111111111111111111d222222222222e1111111111111111111111
1111111111111111111111111111111111111111111111111111111111111111111111111
1111111111111111111111111111111111111111111111111111111111111111111111111
1111111111111111111111111111111111111111111111111111111111111111111111111
1111111111111111111111111111111111111111111111111111111111111111111111111
1111111111111111111111111111111111111111111111111111111111111111111111111




