200000000000000022222222000000000000000000000000
000000000000000000000002000000000000000000000000
000000000000000000000002000022222222000000000000
200000000000000000000002000020000000000000000000
200000000000000000000002000020000000000000000000
200000000000020000200002000020000000000000000000
200000000000020000200002000000000000000000000000
200000000000020000200002000000000000000000000000
222000000000020000200002222200000000000000000000
112000000000000000200002000000200000000000000000
112000000000000000200002000000002000000000000000
111222222222222222200002000000000002222200000002
111111111111111111200000000000000000000000000002
111111111111111111200000000000000000000000000002
1111111111111111112000000000000000000000000022220
111111111111111111200000000000000000000002000000
111111111111111111200000022222222222222000000000




