000000000000000000000000000000200000000000000000
00000000000000000000000000000020000000000000000
022222000000002222222222220000200000000000000000
000000000000002000000000020000200000000000000000
0000000000000020000000000200002000000000000000000
000000000000002000000002220000200000000000000000
0000000000000020000000000200000000
000000000000002000000000020000000000000000000000
000000000000002000000000020000000000000000000000
000000000000002000000000020000000000000000000000
000000000000002000200000020000222000000000000
0000000000000020002000000200000000000000020
200000000000002000200000020000000000000002000000
200000000000000000200000020000000000000000000000
200000000000000000200000020000000000000000000000
222222222222222222200002220000000002222000000000
000000000000000000200002000000000000000000000000
000000000000000000200002000000000000000000000000
0000000000000000002000020000000000000000000000000
000000000000000000200000000000020000000000000002
000000000000000000200000000000020000000000000002
000000000000000000200000000000022222222222222222
000000000000000000200000000000000000000000000000
000000000000000000200000000000000000000000000000
000000000000000000200000000020000000000000000000
000000000000000000000000000000000000000000000000
000000000000000000000000000000000000000000000000