0000111111222222220000000000000000000000000000000000000000000000000000
0000111111200000000000000000000000000000000000000000000000000000000000
0000111111200000000000000000000001111111111000000000000000000000000000
0000111111200000000000000000000002111111100000000000000000000000000000
0000011111200000000000000000000002111111000000000000000000000000000000
0000001111200000220000000000000002111120000000000000000000000000000000
0000000111200000220000000000000002111200000000000000000000000000000000
0000000011200000220000000000000002112000000000000000000000000000000211
0000000001200000220000000000000002120000002000000002000000000000000211
0000000000200000220002000000002002120000002222222222000000000000000211
0000000000000000220002222222222002120000002111111112000000002222222200
0000000000000000220000111111112002120000002111111112000000002111111111
2222222222222222220000011111112002120000002111111112000000002111111111
1111111111111111110000011111112002120000002111111110000000002111111111
1111111111111111110000011111112002120000002111111110000000000011111111
1111111111111111110000011111112000000000002111111100000000000000111111
1111111111111111110000011111112000000000002111111100000000000000000000
1111111111111111110000011111112000000000000000000000000000000000000000
1111111111111111110000011111112000000022220000000000000000000000000000
1111111111111111110000011111112000000021112000000000000000000000000000
1111111111111111110000011111112000000001110000000000000000000000000000
1111111111111111110000011111112000000000110000000000000000000000000000
