0000722222pjjjjjjh0000000000000000000000000000000000000000000000000000
0000411111300000000000000000000000722222260000000000000000000000000000
0000411111300000000000000000000007e11111fb0000000000000000000000000000
0000cg111130000000000000000000000411111fb00000000000000000000000000000
00000cg1113000000000000000000000041111fb000000000000000000000000000000
000000cg11300000760000000000000004111fb0000000000000000000000000000000
0000000cg130000043000000000000000411fb00000000000000000000000000000000
00000000cg30000043000000000000000411b000000000000000000000000000000722
000000000cq0000043000000000000000413000000a00000000a000000000000000411
000000000090000043000a00000000a00413000000k22222222l000000000000000411
000000000000000043000k22222222l004130000004111111113000000007222222e11
000000000000000043000c5g1111113004130000004111111113000000004111111111
2222222222222222e30000041111113004130000004111111113000000004111111111
1111111111111111130000041111113004130000004111111110000000004111111111
111111111111111113000004111111300c5b0000004111111100000000000011111111
1111111111111111100000041111113000000000004111111000000000000000111111
111111111111111110000000111111300000000000411111000000000000000000000
1111111111111111100000001111113000000000000000000000000000000000000000
1111111111111111100000000111113000000072220000000000000000000000000000
1111111111111111100000000111113000000041100000000000000000000000000000
1111111111111111100000000011113000000001000000000000000000000000000000
1111111111111111100000000001113000000000000000000000000000000000000000
