0000000000222222220000000000000000000000000000000000000000000000000000
0000000000200000000000000000000000000000000000000000000000000000000000
0000000000200000000000000000000000000000000000000000000000000000000000
0000000000200000000000000000000002000000000000000000000000000000000000
0000000000200000000000000000000002000000000000000000000000000000000000
0000000000200000020000000000000002000000000000000000000000000000000000
0000000000200000020000000000000002000000000000000000000000000000000000
0000000000200000020000000000000002000000000000000000000000000000000000
0000000000200000020000000000000002000000002000000002000000000000000000
0000000000200000020002000000002002000000002222222222000000000000000000
0000000000000000020002222222222002000000002000000002000000002222222200
0000000000000000020000000000002002000000002000000002000000000000000000
2222222222222222220000000000002002000000002000000002000000000000000000
0000000000000000000000000000002002000000002000000000000000000000000000
0000000000000000000000000000002002000000002000000000000000000000000000
0000000000000000000000000000002000000000002000000000000000000000000000
0000000000000000000000000000002000000000002000000000000000000000000000
0000000000000000000000000000002000000000000000000000000000000000000000
0000000000000000000000000000002000000022220000000000000000000000000000
0000000000000000000000000000002000000000000000000000000000000000000000
