000000000022222222000000000000000000000000000
000000000020000000000000000000000000000000000
000000000020000000000000000000000000000000000
000000000020000002000000000000000000000000000
000000000020000002000000000000000000000000000
000000000020000002000000000000000000000000000
000000000020000002000000000000000000000000000
000000000020000002000000000000000000000000000
000000000020000002000200000000200000000000000
000000000000000002000222222222200000000000000
000000000000000002000000000000000000000000000
222222222222222222200000000000000000000000000
000000000000000000000000000000000000000000000
000000000000000000000000000000000000000000000
000000000000000000000000000000000000000000000
000000000000000000000000000000000000000000000
