22222222222222222000000000000000000000000000000000
20000000000000002000000000000000000000000000000000
20000000000000002000000000000000000000000000000000
20000000000000002000000000000000000000000000000000
22222222222220002000000000000000000000000000000000
00200000000020002000000000000000000000000000000000
00200000000020002000000000000000000000000000000000
00200000000020002000000000000000000000000000000000
00222222000020000000000000000000000000000000000000
00000002000020000000000000000000000000020000000000
00000002000020000000000000000000000200020000000000
00000002000020000000002000000000000200020000000000
00000002000020000000002222222222222200020000000000
00000002000022222222222000000000000000020000000000
00000002000000000000000000000000000000020000000000
00000002000000000000000000000000000000020000000000
00000002000000000000000000000000000000020000000000
00000002000000000000000000000200000000020000000000
00000002000000000000000000000200000000020000000000
00000002222222222222222222222200000022220000000000