22222222222222222120000000000000000000000000000000
20000000000000002120000000000000000000000000000000
20000000000000002120000000000000000000000000000000
20000000000000002120000000000000000000000000000000
22222222222220002120000000000000000000000000000000
11200000002120002120000000000000000000022222222222
11200000002120002200000000000000000000021111111111
11200000002120000000000000000000000000021111111111
11222200021120000000000000000000000000021111111111
11111200021120000000000000000000000000021111111111
11111200021120000000000000000000000200021111111111
11111200021120000000002000000000000200021111111111
11111200021120000000002222222222222200021111111111
11111200021112222222221111220000000000021111111111
11111200021111111111111222000000000000021111111111
11111200022222222222222000000000000000021111111111
11111200000000000000000000000000000000021111111111
11111200000000000000000000000200000000021111111111
11111200000000000000000000000200000000021111111111
11111222222222222222222222222200000022221111111111
11111111111111111111111111111200000021111111111111
11111111111111111111111111111200000021111111111111
11111111111111111111111111111200000021111111111111
11111111111111111111111111111222222221111111111111
11111111111111111111111111111111111111111111111111
11111111111111111111111111111111111111111111111111
11111111111111111111111111111111111111111111111111
11111111111111111111111111111111111111111111111111
11111111111111111111111111111111111111111111111111