00000000000000007260000000000000000000000000000000
00000000000000004130000000000000000000000000000000
00000000000000004130000000000000000000000000000000
0x00t00s0u0000004130000000000000000000000000000000
72222222222260004130000000000000000000000w0s000t00
41f5555555g130004fb0000000000000000000072222222222
4130000000413000cb00000000000000000000041111111111
413000000u4130000000000000000000000000041111111111
4130000007e130000000000000000000000000041111111111
41d22600041130000000000000000000000u00041111111111
41111300041130000000000000000000000a00041111111111
4111130004113000000000a00t0yu000v00800041111111111
4111130004113000000000k222222222222l00041111111111
411113000411d222222222e11f555555555b00041111111111
4111130004111111111111f55b000000000000041111111111
411113000c555555555555b000000000000000041111111111
41111300000000000000000000000000000000041111111111
41111300000000000000000000000a00000000041111111111
41111300v00000u00000t00v0s000800000000041111111111
41111d22222222222222222222222l000000722e1111111111
41111111111111111111111111111300000041111111111111
41111111111111111111111111111300000041111111111111
4111111111111111111111111111130000u041111111111111
41111111111111111111111111111d222222e1111111111111
41111111111111111111111111111111111111111111111111
41111111111111111111111111111111111111111111111111
41111111111111111111111111111111111111111111111111
11111111111111111111111111111111111111111111111111
11111111111111111111111111111111111111111111111111