11111111111111111111111111111111111111111111111
11111111111111111111111111111111111111111111111
11111111111111111111111111111111111111111111111
11111111111122222222222222222222222221111111111
11111111111120000000000000000000000002111111111
11111111111120000000000000000000000002111111111
11111111111120000000000000000000000002111111111
11111111111120000000000000000000000002111111111
11111111111120000000000000000000000002111111111
11111111111120000000000000000000000002111111111
11111111111120000000000000000000000002111111111
11111111111120000000000000000000000002111111111
11111111111122222222222222222222222221111111111
11111111111111111111111111111111111111111111111
11111111111111111111111111111111111111111111111
11111111111111111111111111111111111111111111111
11111111111111111111111111111111111111111111111
11111111111111111111111111111111111111111111111