000000000000000000000000000000722260000000000000
000000000000000000000000000000411130000000000000
72260000000007pjjjjjjjjjj60000411fb0000000000000
41130000000004300000000008000041fb00000000000000
cg13000000000430000000000800004fb000000000000000
0c5b000000000430000000072l0000cb0000000000000000
0000000000722e3000000004130000000000000000000000
000000000041113000000004130000000000000000000000
0000000000cg113000000004130000000000000000000000
00000000000cg13000000004130000000000000000000000
000000000000cg3000a00004130000ijh000000000000000
0000000000000cq000800004130000000000000007220000
000000000000009000800004130000000000000004100000
000000000000000000800004130000000000000000000000
0000000000000000008000041300000000000a0000000000
222222222222222222l0000o5b00000000072m6000000000
111111111111111111300008000000000004113000000000
111111111111111111300008000000000000000000000000
1111111111111111113000090000000000000000000000000
1111111111111111113000000000000a00000000000000072222
1111111111111111113000000000000k2600000000000004111
1111111111111111113000000000000cgd2222222222222e11
11111111111111111130000000000000cg1111111111111111
111111111111111111300000000072200c55g1111111111111
11111111111111111130000000004110000041111111111111
00000000000000000000000000000100000001111111111111
000000000000000000000000000000000000000000000000