000000000000000000000000000000211110000000000000
000000000000000000000000000000211110000000000000
222200000000022222222222220000211120000000000000
211200000000022000000000020000211200000000000000
211200000000022000000000020000212000000000000000
022200000000022000000002220000220000000000000000
000000000022112000000002120000000000000000000000
000000000021112000000002120000000000000000000000
000000000021112000000002120000000000000000000000
000000000002112000000002120000000000000000000000
000000000000212000200002120000222000000000200000
000000000000022000200002120000110000000002120000
200000000000002000200002120000000000000002120000
200000000000000000200002120000000000000000200000
200000000000000000200002120000000000020000000000
222222222222222222200002220000000002212000000000
111111111111111111200002000000000002112000000000
111111111111111111200002000000000000000000000000
1111111111111111112000020000000000000000000000000
1111111111111111112000000000000200000000000000022222
111111111111111111200000000000020000000000000002111
11111111111111111120000000000002222222222222222211
11111111111111111120000000000000211111111111111111
11111111111111111120000000000200021111111111111111
11111111111111111120000000002120000021111111111111
00000000000000000000000000000200000001111111111111
000000000000000000000000000000000000000000000000