000000000000000000000000000000
000000000000000000000000000000
000000000000000000000000000000
000000000000000000000000000000
000000000000000000000000000000
000000000000000000000000000000
000000000000000000000000000000
222000022222200000000000000000
112000000000000000000000000000
112000000000000002200000022000
11122222222222222112222221122222222222222222222222222222222222222222222222222222222222
11111111111111111111111111110011111111111111111111111111111111111111111111111111111111
11111111111111111111111111000011111111111111111111111111111111111111111111111111111111
11111111111111111111111111000011111111111111111111111111111111111111111111111111111111
11111111111111111111111100000011111111111111111111111111111111111111111111111111111111
11111111111111111110000000000011111111111111111111111111111111111111111111111111111111