000000000000000000000000000000000000000200000
000000000000000002000000002000000000000200000
222222220000000002222222222000000000000000000
000000000000000002000000000020000000000000000
000000000000000002000000000000000000000000000
000000000000000222000000000000000000020000000
000000000000000000000000000000000000020000000
000000000000000000000000000000000000000000000
000000000000000000000000000200000000000000000
000000000000000000000000000200000000000000000
000000000000000000000000000000000000000000000
000000000000000000000000000000000000000000000
000000000000000200000000000000000200000000000
000000000000000222222222222222222200000000000
000000200000020000000000000000000000000000000
000000200000000000000000000000000000000000000
000000000000000000000000000000000000000000000
000000000000000000000000000000000000000000000
000000000020000000000000000000000020000000000
000000000022222222222222222222222200000000000