20000000000000000000000000000022200002222222002000200020202020000200000222222
200000000000000000000000000020000000000000000
2000020000000000000000000002000000000000000000
200002000000000000000000200000000000000000000
200000000000000000000200000000000000000000000
200000000000000000020000000000000000000000000
222222222222222222000000000000000000000000000
111111111111111111000000000000000000000000000
111111111111111111000000000000000000000000000
111111111111111111000000000000000000000000000
111111111111111111000000000000000000000000000
111111111111111111000000000000000000000000000