000000000000000000000000000000000000000222200
000000000000000002000000002000000000000211200
222222220000000002222222222000000000000022000
111111120000000002111111111120000000000000000
001111120000000002111111111120000000000000000
000011120000000222111111111200000000020000000
000000000000000011111100000000000000212000000
000000000000000001110000000000000002112000000
000000000000000000100000022200000002222000000
000000000000000000000000021200000000000000000
000000000000000000000000000000000000000000000
000000000000000000000000000000000020000000000
000000000000000200000000000000000212000000000
000000000000000222222222222222222112000000000
000222200000021111111111111111111112000000000
002111200000021111111111111111111112000000000
002111200000000000000000000000000000000000000
002222200000000000000000000000000000000000000
000000000020000000000000000000000200000000000
000000000022222222222222222222222200000000000
000000000021111111111111111111111200000000000
000000000021111111111111111111111200000000000
000000000021111111111111111111111200000000000
000000000021111111111111111111111200000000000
000000000021111111111111111111111200000000000
000000000021111111111111111111111200000000000