000000000000000000000000000000000000000722600
00000000000000000a00000000a000000000000cgfb00
72222226000000000k22222222l0000000000000cb000
c5g11113000000000411111111d260000000000000000
00c5g1130000000004111111111fb0000000000000000
0000c55b0000000ire111f55555b000000000a0000000
0000000000000000cg1f5b000000000000007m6000000
00000000000000000cnb0000000000000007e13000000
00000000000000000090000002260000000c55b000000
000000000000000000000000001300000000000000000
000000000000000000000000000000000000000000000
0000000000000000000000000000000000a0000000000
000000000000000a000000000000000007m6000000000
000000000000000k22222222222222222e13000000000
000222600000072e11111111111111111113000000000
0001113000000c555555555555555555555b000000000
000011300000000000000000000000000000000000000
000000300000000000000000000000000000000000000
0000000000a0000000000000000000000a00000000000
0000000000k2222222222222222222222l00000000000
000000000041111111111111111111111300000000000
000000000041111111111111111111111300000000000
000000000041111111111111111111111300000000000
000000000041111111111111111111111300000000000
000000000041111111111111111111111300000000000
000000000041111111111111111111111300000000000