000000000000000000000000000000000000000000000000000000000
00000000000000000000000000000000a000000000000000000000000
00000000000000000000000000000007m600000000000000000000000
0000000000000000000000000000000c5b00000000000000000000000
000000000007260000000000000000000000000000000000000000000
000000000004130000000000000000000000000007260000000000000
00000000000413000000007260000000000000000cg30000000000000
0000000000041300000000c5b00000a00000000000cb000000000000411111111111
0000000a000413000000000000000080000000000000000000000000411111111111
2222222l0004130000000000000000k2260000000000000000000000411111111111
111111fb0004130007600000000000411d2222226000000000000000411111111111
11111fb0000c5b000cb000007600004111111111d222222222220000411111111111
1111fb00000000000000000043000041111111111111110000000000411111111111
11f5b000000000000000000043000041f55555555555500000000000411111111111
1fb00000000000000a00000043000041300000000000000000000000411111111111
5b000000000000007m222222e3000041300000000000000000000000411111111111
000000000000000041111111130000413000000000000000a0000000411111111111
000000000726000041111111130000cgd222222222222222l0000000411111111111
000000000cg30000cg11111113000004111111111111111130000000411111111111
00000000004300000411111110000004111111111111111130000000411111111111
00000000004300000411111100000000111111111111111130000000411111111111
00000000004300000011111000000000011111111111111130000000411111111111
00000000004300000011110000000000000111111111111130000000411111111111