000000000000000000000000000000000000000000000000000000000
000000000000000000000000000000002000000000000000000000000
000000000000000000000000000000021200000000000000000000000
000000000000000000000000000000021200000000000000000000000
000000000002120000000000000000000000000000000000000000000
000000000002120000000000000000000000000000200000000000000
000000000002120000000022200000000000000002120000000000000
00000000000212000000002120000020000000000020000000000000211111111111
00000002000212000000000000000020000000000000000000000000211111111111
22222222000212000000000000000022220000000000000000000000211111111111
11111112000212000220000000000021112222222000000000000000211111111111
11111120000212000110000022000021111111111222222222220000211111111111
11111200000000000000000022000021111111111111111120000000211111111111
11112000000000000000000022000021111111111111112000000000211111111111
11100000000000000200000022000021200000000000000000000000211111111111
11000000000000002222222222000021200000000000000000000000211111111111
10000000000000002111111112000021200000000000000020000000211111111111
00000000022200002111111112000022222222222222222220000000211111111111
00000000011200002111111112000001111111111111111120000000211111111111
00000000001200000211111120000001111111111111111120000000211111111111
00000000001200000211111120000001111111111111111120000000211111111111
00000000001200000211111120000001111111111111111120000000211111111111
00000000001200000211111120000001111111111111111120000000211111111111