000000000000000000000000000000000000000000000000000000000
000000000000000000000000000000000000000000000000000000000
000000000000000000000000000000000200000000000000000000000
000000000000000000000000000000000200000000000000000000000
000000000000200000000000000000000000000000000000000000000
000000000000200000000000000000000000000002000000000000000
000000000000200000000022200000000000000002000000000000000
000000000000200000000000000000200000000000000000000000000
000000020000200000000000000000200000000000000000000000002
222200000000200000000000000000222200000000000000000000002
000000000000200002200000000000200022222220000000000000002
000000000000200000000000020000200000000002222222222200002
000000000000000000000000000000200000000000000000000000002
000000000000000000000000000000200000000000000000000000002
000000000000000000000000000000200000000000000000000000002
000000000000000022220000000000200000000000000000000000002
000000000000000000000000000000200000000000000000200000002
000000000222000000000000000000222222222222222222200000002