0000000000000000000000000000000000000000000000000000000000000000000
0000000000000000000000000000000000000000000000000000000000000000000
0000000000000000000000000000000000000000000000000000000000000000000
0000000000000000000000000000000000000000000000000000000000000000000
0000000000000000000000000000000000000000000000000000000000000000000
0000002000000000000000000000000000000000000000000000000000000000000
0000002000000000000000000000000000000000000000000000000000000000000
0000002000000000000000000000000000000000000000000000000002000000000
0000000000000000200000000000002000000000000000000000000002000000000
0000000000000000200000000000002000000222000000000000000002000000000
2222222220000000222222222222222000000022000000002222222222222222222
1111111120000000211111111111112000000002000000002111111111111111111
1111111120000000211111111111120000000002000000002111111111111111111
1111111120000000211111111111120000000002000000002111111111111111111
1111111120000000211111111111200000000000000000002111111111111111111
1111111122222222211111111111200000000000000000002111111111111111111