0000000000000000000000000000000000000000000000000000000000000000000
0000000000000000000000000000000000000000000000000000000000000000000
0000000000000000000000000000000000000000000000000000000000000000000
000t000000000000000000000000000000000000000000000000000000000000000
000760t000000000000000000000000000000000000000000000000000000000000
0004d26000000000000000000000000000000000000000000000000000000000000
000c5g3000000000000000000000000000000000000000000000000000000000000
00000cb000000000000000000000000000000000000000000000000000000000000
000000000000000a0000000000000sav00000u0t000000000000000000000000000
s@00ut000000000k60s0tu00v0s007m600000ir60000000000us0X0t000s0000000
2222222260000004d222222222222e1300000043000000007222222222222222222
111111113000000cg111111111111f5b000000cq000000004111111111111111111
1111111130000000411111111111130000000008000000004111111111111111111
1111111130000000411111111111fb0000000009000000004111111111111111111
1111111130u0s00v411111111111300000000000000000004111111111111111111
11111111d2222222e11111111111300000000000000000004111111111111111111
1111111111111111111111111111300000000000000000004111111111111111111
1111111111111111111111111111300000000000000000004111111111111111111
1111111111111111111111111111300000000000000000004111111111111111111
1111111111111111111111111111300000000000000000004111111111111111111
1111111111111111111111111111300000000000000000004111111111111111111