0000000000000000000000000000000000000000000000000000000000000000000
0000000000000000000000000000000000000000000000000000000000000000000
0000000000000000000000000000000000000000000000000000000000000000000
0000000000000000000000000000000000000000000000000000000000000000000
0007600000000000000000000000000000000000000000000000000000000000000
0004d26000000000000000000000000000000000000000000000000000000000000
000c5g3000000000000000000000000000000000000000000000000000000000000
00000cb000000000000000000000000000000000000000000000000002000000000
000000000000000a00000000000000a000000000000000000000000002000000000
0000000000000004600000000000071600000226000000000000000002000000000
2222222260000004d222222222222e1300000013000000007222222222222222222
111111113000000cg111111111111f5b00000013000000004111111111111111111
1111111130000000411111111111130000000003000000004111111111111111111
1111111130000000411111111111fb0000000003000000004111111111111111111
1111111130000000411111111111300000000000000000004111111111111111111
11111111d2222222e11111111111300000000000000000004111111111111111111
1111111111111111111111111111300000000000000000004111111111111111111
1111111111111111111111111111300000000000000000004111111111111111111
1111111111111111111111111111300000000000000000004111111111111111111
1111111111111111111111111111300000000000000000004111111111111111111
1111111111111111111111111111300000000000000000004111111111111111111